**********
*   h  H *
*hh++++++*
*****+****
*HHHH+   *
*+++++++h*
*HHHH+hhh*
*++++++++*
*    hh  *
**********
